юбил`ею Алекс`ея	Росс`ийская госуд`арственная библиот`ека посвящ`ает сво`ю в`ыставку юбил`ею 
Алекс`ея Суворина	Росс`ийская госуд`арственная библиот`ека посвящ`ает сво`ю в`ыставку юбил`ею Алекс`ея 
дня рожд`ения	В`ыставка посвящен`а 170-летию со дня 
рожд`ения Алекс`ея	В`ыставка посвящен`а 170-летию со дня рожд`ения 
Алекс`ея Серг`еевича	В`ыставка посвящен`а 170-летию со дня рожд`ения Алекс`ея 
Серг`еевича Суворина	В`ыставка посвящен`а 170-летию со дня рожд`ения Алекс`ея Серг`еевича 
произвед`ения Баратынского	Он од`ин из п`ервых издав`ал произвед`ения 
дня см`ерти	Одн`им из с`амых знач`ительных соб`ытий ст`ало изд`ание к 50-летию со дня 
см`ерти Алекс`андра	Одн`им из с`амых знач`ительных соб`ытий ст`ало изд`ание к 50-летию со дня см`ерти 
Алекс`андра Серг`еевича	Одн`им из с`амых знач`ительных соб`ытий ст`ало изд`ание к 50-летию со дня см`ерти Алекс`андра 
Серг`еевича П`ушкина	Одн`им из с`амых знач`ительных соб`ытий ст`ало изд`ание к 50-летию со дня см`ерти Алекс`андра Серг`еевича 
собр`ания сочин`ений	Одн`им из с`амых знач`ительных соб`ытий ст`ало изд`ание к 50-летию со дня см`ерти Алекс`андра Серг`еевича П`ушкина 10-томного собр`ания 
т`ысяч экземпл`яров	Одн`им из с`амых знач`ительных соб`ытий ст`ало изд`ание к 50-летию со дня см`ерти Алекс`андра Серг`еевича П`ушкина 10-томного собр`ания сочин`ений вел`икого по`эта тираж`ом 100 т`ысяч 
Ист`ория Екатер`ины	Ос`обое пристр`астие Суворин им`ел к произвед`ениям по ист`ории своег`о от`ечества и на в`ыставке б`удут предст`авлены так`ие альб`омы как Ист`ория 
Г`ордость изд`ателя	Г`ордость 
изд`ателя Суворина	Г`ордость изд`ателя 
тал`ант Суворина</w>-<w><ana lex="журналист" gr="S,m,anim=sg,gen" joined="hyphen"></ana>журнал`иста	На в`ыставке в РГБ м`ожно б`удет ув`идеть Санкт-Петербургские в`едомости где прояв`ился блест`ящий тал`ант 
ценз`уры разреш`ения	Он был во глав`е литерат`урного худ`ожественного `общества добив`ался от ценз`уры 
р`амках меропри`ятий	В р`амках 
дня рожд`ения	В р`амках меропри`ятий к 170-летию со дня 
рожд`ения Суворина	В р`амках меропри`ятий к 170-летию со дня рожд`ения 
ф`ункции подд`ержки	К офшорному аутсорсингу гот`ова треть миров`ых комп`аний Св`ыше 30 комп`аний план`ируют в теч`ение сл`едующих 12 м`есяцев перед`ать ф`ункции 
вари`ант экон`омии	Так`ое же кол`ичество опр`ошенных рассм`атривают под`обный вари`ант 
экон`омии расх`одов	Так`ое же кол`ичество опр`ошенных рассм`атривают под`обный вари`ант экон`омии 
Аутсорсингом бизнес-проц`ессов	Аутсорсингом 
`уровне сов`ета	В 38 комп`аний уч`аствовавших в иссл`едовании вопр`ос о перех`оде на офшорный аутсорсинг рассм`атривается на `уровне 
сов`ета директор`ов	В 38 комп`аний уч`аствовавших в иссл`едовании вопр`ос о перех`оде на офшорный аутсорсинг рассм`атривается на `уровне сов`ета 
расх`оды их	Подавл`яющее большинств`о опр`ошенных топ</w>-<w><ana lex="менеджер" gr="S,m,anim=pl,gen" joined="hyphen"></ana>менеджеров заяв`или о том что расх`оды 
их комп`аний	Подавл`яющее большинств`о опр`ошенных топ</w>-<w><ana lex="менеджер" gr="S,m,anim=pl,gen" joined="hyphen"></ana>менеджеров заяв`или о том что расх`оды их 
Вл`асти Дубая	Вл`асти 
стремл`ение прав`ительств	`Этому должн`ы спос`обствовать н`изкие нал`оги как для комп`аний так и для ч`астных лиц а т`акже стремл`ение 
н`уждам б`изнеса	`Этому должн`ы спос`обствовать н`изкие нал`оги как для комп`аний так и для ч`астных лиц а т`акже стремл`ение прав`ительств идт`и навстр`ечу н`уждам 
з`она аутсорсинга	В и`юне в Дубае был`а с`оздана п`ервая в м`ире своб`одная з`она 
ц`ентра Дубая</w>-<w><ana lex="Dubai" gr="NONLEX" joined="hyphen"></ana>Dubai	Исполн`ительный дир`ектор технолог`ического ц`ентра 
ист`очник пр`ибыли	Исполн`ительный дир`ектор технолог`ического ц`ентра Дубая</w>-<w><ana lex="Dubai" gr="NONLEX" joined="hyphen"></ana>Dubai Internet City DIC своб`одной з`оны электр`онной торг`овли ОАЭ Бен Сулейман Bin Sulaiman заяв`ил о том что ИТ-подразделения четырёх б`анков двух м`естных одног`о регион`ального и одног`о междунар`одного б`удут превращен`ы в отд`ельные аутсорсинговые комп`ании что позв`олит б`анкам преврат`ить их в ист`очник 
торг`овле `острова	Мин`истр по электр`онной торг`овле 
ч`астью Великобрит`ании	Мы не явл`яемся ч`астью 
слов`ам г-на	По слов`ам 
г-на Крейна	По слов`ам г-на 
заключ`ении мемор`андумов	По слов`ам г-на Крейна ег`о `остров уж`е ведёт перегов`оры о заключ`ении 
Прав`ительство `острова	Прав`ительство 
отключ`ений электр`ичества	Прав`ительство `острова х`очет получ`ить разреш`ение для регламент`ированных комп`аний осуществл`ять сво`ю д`еятельность с `острова Мэн в сл`учае форс-мажорных обсто`ятельств ураг`анов террорист`ических ат`ак `или отключ`ений 
Вин`овник ДТП	Вин`овник 
р`озыски вод`ителя	Нем`ецкой пол`иции д`аже не пришл`ось тр`атить вр`емя на р`озыски 
м`еста происш`ествия	Нем`ецкой пол`иции д`аже не пришл`ось тр`атить вр`емя на р`озыски вод`ителя кот`орый вр`езался в чуж`ую маш`ину и скр`ылся с м`еста 
стр`ажам пор`ядка	Наруш`итель дор`ожного движ`ения был зад`ержан благодар`я с`обственной сообраз`ительности когд`а обрат`ился к стр`ажам 
`юге Герм`ании	38-летний вод`итель вр`езался в друг`ой автомоб`иль недалек`о от г`орода Лоерах на `юге 
офиц`ера пол`иции	Но вск`оре мужч`ина обнар`ужил что заблуд`ился и притормоз`ил у патр`ульной маш`ины в кот`орую как раз сад`ились два офиц`ера 
стр`ажи пор`ядка	Наруш`итель не подозрев`ал что стр`ажи 
опис`ание вод`ителя	Наруш`итель не подозрев`ал что стр`ажи пор`ядка сад`ились в маш`ину чт`обы отпр`авиться на ег`о п`оиски п`осле тог`о как им позвон`ил потерпевший и дал подр`обное опис`ание 
Сотр`удники пол`иции	Сотр`удники 
экон`омию их	А т`акже в`ысказали ем`у благод`арность за экон`омию 
их вр`емени	А т`акже в`ысказали ем`у благод`арность за экон`омию их 
`адрес стать`и	Обсуд`ите стать`ю на ф`оруме Отпр`авить по п`очте Посто`янный `адрес 
корреспонд`енту РИА	Как сообщ`или корреспонд`енту 
рай`оне посёлка	Как сообщ`или корреспонд`енту РИА Н`овости в шт`абе Новгородской поиск`овой экспед`иции Дол`ина 13 сентябр`я отр`яды Дол`ины начн`ут раб`оты в рай`оне 
г`орода Петропавловска	Возм`ожно к росс`ийским поисковик`ам присоедин`ятся их колл`еги из г`орода 
теч`ение р`яда	Раб`оты у населённого п`ункта Сутоки и в ур`очище Надеевка бойц`ы Дол`ины пров`одят ежег`одно в теч`ение 
пол`ях сраж`ений	По их оконч`ании н`айденные на пол`ях 
ост`анки фронтовик`ов	По их оконч`ании н`айденные на пол`ях сраж`ений ост`анки 
ор`ужие времён	По их оконч`ании н`айденные на пол`ях сраж`ений ост`анки фронтовик`ов со вс`еми п`очестями б`удут пр`еданы земл`е на новгородских в`оинских мемори`алах ор`ужие 
времён войн`ы	По их оконч`ании н`айденные на пол`ях сраж`ений ост`анки фронтовик`ов со вс`еми п`очестями б`удут пр`еданы земл`е на новгородских в`оинских мемори`алах ор`ужие времён 
д`анным шт`аба	Согл`асно д`анным 
шт`аба экспед`иции	Согл`асно д`анным шт`аба 
отр`яды экспед`иции	Согл`асно д`анным шт`аба экспед`иции Дол`ина с 1988 г`ода отр`яды 
пол`ях сраж`ений	Согл`асно д`анным шт`аба экспед`иции Дол`ина с 1988 г`ода отр`яды экспед`иции обнар`ужили на пол`ях 
т`ысяч фронтовик`ов	Согл`асно д`анным шт`аба экспед`иции Дол`ина с 1988 г`ода отр`яды экспед`иции обнар`ужили на пол`ях сраж`ений и перезахорон`или на в`оинских мемори`алах б`олее 70 т`ысяч 
Зак`оном РФ	П`оиск`овые раб`оты в реги`оне проводятся в соотв`етствии с Зак`оном 
увеков`ечении п`амяти	П`оиск`овые раб`оты в реги`оне проводятся в соотв`етствии с Зак`оном РФ Об увеков`ечении 
защ`ите От`ечества	П`оиск`овые раб`оты в реги`оне проводятся в соотв`етствии с Зак`оном РФ Об увеков`ечении п`амяти пог`ибших при защ`ите 
Вл`асти Изр`аиля	Вл`асти 
проникнов`ению боевик`ов	Вл`асти Изр`аиля обвин`или офици`альный Дам`аск в том что сир`ийские вл`асти спос`обствуют проникнов`ению 
террит`ории Сирии	Вл`асти Изр`аиля обвин`или офици`альный Дам`аск в том что сир`ийские вл`асти спос`обствуют проникнов`ению боевик`ов в Ирак с террит`ории 
дестабилизации обстан`овки	Вл`асти Изр`аиля обвин`или офици`альный Дам`аск в том что сир`ийские вл`асти спос`обствуют проникнов`ению боевик`ов в Ирак с террит`ории Сирии что ведёт к дестабилизации 
нач`альник Геншт`аба	Соотв`етствующее заявл`ение сд`елал сег`одня нач`альник 
проникнов`ению террор`истов	Сирия не предприним`ает никак`их мер для тог`о чт`обы противод`ействовать проникнов`ению 
вл`асти Сирии	При `этом офици`альные вл`асти 
поз`иция руков`одства	`Эта поз`иция 
руков`одства стран`ы	`Эта поз`иция руков`одства 
Администр`ация Джорджа	Администр`ация 
Джорджа Б`уша	Администр`ация Джорджа 
сп`исок госуд`арств	Администр`ация Джорджа Б`уша внесл`а `эту стран`у в сп`исок 
Сов`ет Безоп`асности	Т`акже ст`оит отм`етить что друг`ой гл`авной пробл`емой в отнош`ениях м`ежду Израилем и Сирией явл`яются Голанские выс`оты принадлеж`авшие Сирии и оккуп`ированные Израилем в х`оде шестидневной войн`ы в 1967 г а факт`ически аннекс`ированные в 1981 г что н`е было пр`изнано миров`ым со`обществом Сов`ет 
Безоп`асности О`ОН	Т`акже ст`оит отм`етить что друг`ой гл`авной пробл`емой в отнош`ениях м`ежду Израилем и Сирией явл`яются Голанские выс`оты принадлеж`авшие Сирии и оккуп`ированные Израилем в х`оде шестидневной войн`ы в 1967 г а факт`ически аннекс`ированные в 1981 г что н`е было пр`изнано миров`ым со`обществом Сов`ет Безоп`асности 
подпис`ания соглаш`ения	П`осле подпис`ания 
рай`оне дол`ины	Наиб`олее крупномасшт`абные во`енные д`ействия м`ежду сир`ийскими и изр`аильскими войск`ами им`ели м`есто в 1982 год`у в рай`оне 
дол`ины Бекаа	Наиб`олее крупномасшт`абные во`енные д`ействия м`ежду сир`ийскими и изр`аильскими войск`ами им`ели м`есто в 1982 год`у в рай`оне дол`ины 
Поп`ытки перегов`оров	Поп`ытки 
п`оводу судьб`ы	Посл`едние по вр`емени м`ирные перегов`оры м`ежду Израилем и Сирией прерв`ал`ись в 2000 г в связ`и с разногл`асиями по п`оводу 
к`ачестве усл`овия	Сирия в к`ачестве 
усл`овия нач`ала	Сирия в к`ачестве усл`овия 
нач`ала перегов`оров	Сирия в к`ачестве усл`овия нач`ала 
руков`одства предоставл`ения	Сирия в к`ачестве усл`овия нач`ала перегов`оров тр`ебует от Изр`аиля офици`ального заявл`ения об ух`оде с Голанских выс`от офици`альный Изр`аиль с `этим категор`ически не согл`асен тр`ебуя от сир`ийского руков`одства 
гар`антий безоп`асности	Сирия в к`ачестве усл`овия нач`ала перегов`оров тр`ебует от Изр`аиля офици`ального заявл`ения об ух`оде с Голанских выс`от офици`альный Изр`аиль с `этим категор`ически не согл`асен тр`ебуя от сир`ийского руков`одства предоставл`ения твёрдых и надёжных гар`антий 
секрет`арь О`ОН	Генер`альный секрет`арь 
прекращ`ением огн`я	Генер`альный секрет`арь О`ОН Кофи Аннан рекомендов`ал продл`ить манд`ат междунар`одной м`иссии по наблюд`ению за прекращ`ением 
конц`а декабр`я	Генер`альный секрет`арь О`ОН Кофи Аннан рекомендов`ал продл`ить манд`ат междунар`одной м`иссии по наблюд`ению за прекращ`ением огн`я на Голанских выс`отах до конц`а 
С`илы О`ОН	Генер`альный секрет`арь О`ОН Кофи Аннан рекомендов`ал продл`ить манд`ат междунар`одной м`иссии по наблюд`ению за прекращ`ением огн`я на Голанских выс`отах до конц`а декабр`я с г С`илы 
прекращ`ением огн`я	Генер`альный секрет`арь О`ОН Кофи Аннан рекомендов`ал продл`ить манд`ат междунар`одной м`иссии по наблюд`ению за прекращ`ением огн`я на Голанских выс`отах до конц`а декабр`я с г С`илы О`ОН б`ыли размещен`ы на Голанских выс`отах в м`ае 1974 г для наблюд`ения за прекращ`ением 
наблюд`ателей О`ОН	Кр`оме тог`о на Голанских выс`отах нах`одятся 78 во`енных наблюд`ателей 
Н`овости телеканала	Н`овости 
телеканала РБК	Н`овости телеканала 
террит`ории КНДР	На террит`ории 
террит`ории КНДР	Ссыл`аясь на анон`имные ист`очники в Сеуле аг`ентство сообщ`ает что южнокорейские сейсм`ологи зарегистр`ировали два очаг`а сейсм`ической акт`ивности на террит`ории 
М`ощность взр`ыва	М`ощность 
террит`ории КНДР	М`ощность взр`ыва происш`едшего на террит`ории 
Госсекретарь США	Госсекретарь 
сообщ`ению телекомпании	Госсекретарь США Колин Пауэлл однозн`ачно заяв`ил США счит`ают что КНДР не провод`ила `ядерных испыт`аний по сообщ`ению 
мн`ение ж`ителей	Южнокорейские СМИ прив`одят мн`ение 
д`анным ист`очника	По д`анным 
з`апуском рак`еты	По д`анным ист`очника происш`едшее могл`о быть лесн`ым пож`аром пром`ышленным взр`ывом неуд`ачным з`апуском 
з`апуск рак`еты	Р`анее многоч`исленные СМИ публиков`али разл`ичные в`ерсии происш`едшего на с`евере КНДР в ночь с 8 на 9 сентябр`я 2004 г Предполаг`алось что в С`еверной Кор`ее могл`и произойт`и испыт`ания `ядерного ор`ужия управл`яемый `или неуправл`яемый взрыв об`ычных вооруж`ений неуд`ачный з`апуск 
с`евере КНДР	Нап`омним что сег`одня в разл`ичных СМИ появ`ились сообщ`ения о том что на с`евере 
взрыв п`оезда	Как сообщ`ает информаци`онное аг`ентство Yonhap со сс`ылкой на д`анные анон`имного ист`очника в Пекине `этот взрыв был намн`ого б`олее м`ощным чем взрыв 
дел`ам объедин`ения	По слов`ам южнокорейского мин`истра по дел`ам 
объедин`ения Чуна	По слов`ам южнокорейского мин`истра по дел`ам объедин`ения 
Чуна Дон	По слов`ам южнокорейского мин`истра по дел`ам объедин`ения Чуна 
Дон Ена	По слов`ам южнокорейского мин`истра по дел`ам объедин`ения Чуна Дон 
пров`инции КНДР	Он отм`етил что взрыв произошёл в с`еверной пров`инции 
годовщ`ина рожд`ения	Отмеч`ается 63-я годовщ`ина 
дня рожд`ения	63-я годовщ`ина со дня 
Прик`азом нарк`ома	Прик`азом 
нарк`ома СССР	Прик`азом нарк`ома 
т`ысяч объедин`ений	В г`оды Вел`икой От`ечественной войн`ы св`ыше 4 5 т`ысяч 
комит`ета ветер`анов	ИТАР-ТАСС председ`атель объединённого сов`ета Моск`овского комит`ета 
ветер`анов войн`ы	ИТАР-ТАСС председ`атель объединённого сов`ета Моск`овского комит`ета ветер`анов 
тыс фронтовик`ов</w>-<w><ana lex="гвардеец" gr="S,m,anim=pl,gen" joined="hyphen"></ana>гвард`ейцев	ИТАР-ТАСС председ`атель объединённого сов`ета Моск`овского комит`ета ветер`анов войн`ы Бор`ис Гормылев в Москв`е насч`итываются 11 тыс 
с`имволом призн`ания	ИТАР-ТАСС председ`атель объединённого сов`ета Моск`овского комит`ета ветер`анов войн`ы Бор`ис Гормылев в Москв`е насч`итываются 11 тыс фронтовик`ов</w>-<w><ana lex="гвардеец" gr="S,m,anim=pl,gen" joined="hyphen"></ana>гвард`ейцев для кот`орых `это зв`ание ст`ало с`имволом 
призн`ания м`ужества	ИТАР-ТАСС председ`атель объединённого сов`ета Моск`овского комит`ета ветер`анов войн`ы Бор`ис Гормылев в Москв`е насч`итываются 11 тыс фронтовик`ов</w>-<w><ana lex="гвардеец" gr="S,m,anim=pl,gen" joined="hyphen"></ana>гвард`ейцев для кот`орых `это зв`ание ст`ало с`имволом призн`ания 
округ`ах стол`ицы	По сл`учаю 63-й годовщ`ины в ветер`анских организ`ациях пройд`ут торж`ественные собр`ания в подш`ефных шк`олах встр`ечи с молодёжью а в администрат`ивных округ`ах 
возлож`ения цвет`ов	По сл`учаю 63-й годовщ`ины в ветер`анских организ`ациях пройд`ут торж`ественные собр`ания в подш`ефных шк`олах встр`ечи с молодёжью а в администрат`ивных округ`ах стол`ицы состо`ятся возлож`ения 
п`амятникам защ`итников	По сл`учаю 63-й годовщ`ины в ветер`анских организ`ациях пройд`ут торж`ественные собр`ания в подш`ефных шк`олах встр`ечи с молодёжью а в администрат`ивных округ`ах стол`ицы состо`ятся возлож`ения цвет`ов к п`амятникам 
защ`итников Р`одины	По сл`учаю 63-й годовщ`ины в ветер`анских организ`ациях пройд`ут торж`ественные собр`ания в подш`ефных шк`олах встр`ечи с молодёжью а в администрат`ивных округ`ах стол`ицы состо`ятся возлож`ения цвет`ов к п`амятникам защ`итников 
пост`а председ`ателя	78-летний кит`айский л`идер Цзян Цзэминь п`одал прош`ение об отст`авке с пост`а 
пл`енуме ЦК	78-летний кит`айский л`идер Цзян Цзэминь п`одал прош`ение об отст`авке с пост`а председ`ателя Центр`ального во`енного сов`ета ЦВС КНР на проход`ящем в Пекине пл`енуме 
ЦК комп`артии	78-летний кит`айский л`идер Цзян Цзэминь п`одал прош`ение об отст`авке с пост`а председ`ателя Центр`ального во`енного сов`ета ЦВС КНР на проход`ящем в Пекине пл`енуме ЦК 
комп`артии Кит`ая	78-летний кит`айский л`идер Цзян Цзэминь п`одал прош`ение об отст`авке с пост`а председ`ателя Центр`ального во`енного сов`ета ЦВС КНР на проход`ящем в Пекине пл`енуме ЦК комп`артии 
Реш`ение чл`енов	Об `этом сообщ`ает сег`одня из кит`айской стол`ицы изда`ющаяся в Сянгане информированная газ`ета Саут Чайна морнинг пост ссыл`аясь на кит`айские ист`очники Реш`ение 
чл`енов ЦК	Об `этом сообщ`ает сег`одня из кит`айской стол`ицы изда`ющаяся в Сянгане информированная газ`ета Саут Чайна морнинг пост ссыл`аясь на кит`айские ист`очники Реш`ение чл`енов 
ЦК КПК	Об `этом сообщ`ает сег`одня из кит`айской стол`ицы изда`ющаяся в Сянгане информированная газ`ета Саут Чайна морнинг пост ссыл`аясь на кит`айские ист`очники Реш`ение чл`енов ЦК 
день раб`оты	Об `этом сообщ`ает сег`одня из кит`айской стол`ицы изда`ющаяся в Сянгане информированная газ`ета Саут Чайна морнинг пост ссыл`аясь на кит`айские ист`очники Реш`ение чл`енов ЦК КПК на `этот счёт ожид`ается в предсто`ящее воскрес`енье в посл`едний день 
раб`оты пл`енума	Об `этом сообщ`ает сег`одня из кит`айской стол`ицы изда`ющаяся в Сянгане информированная газ`ета Саут Чайна морнинг пост ссыл`аясь на кит`айские ист`очники Реш`ение чл`енов ЦК КПК на `этот счёт ожид`ается в предсто`ящее воскрес`енье в посл`едний день раб`оты 
пост`у председ`ателя	Тогд`а же произойдёт утвержд`ение на пост`у 
председ`ателя ЦВС	Тогд`а же произойдёт утвержд`ение на пост`у председ`ателя 
ЦВС председ`ателя	Тогд`а же произойдёт утвержд`ение на пост`у председ`ателя ЦВС 
председ`ателя КНР	Тогд`а же произойдёт утвержд`ение на пост`у председ`ателя ЦВС председ`ателя 
секретар`я ЦК	Тогд`а же произойдёт утвержд`ение на пост`у председ`ателя ЦВС председ`ателя КНР и генер`ального секретар`я 
ЦК КПК	Тогд`а же произойдёт утвержд`ение на пост`у председ`ателя ЦВС председ`ателя КНР и генер`ального секретар`я ЦК 
Ху Цзиньтао	Тогд`а же произойдёт утвержд`ение на пост`у председ`ателя ЦВС председ`ателя КНР и генер`ального секретар`я ЦК КПК 61-летнего Ху 
проц`есс перед`ачи	Так`им `образом отмеч`ает газ`ета б`удет п`олностью завершён проц`есс 
перед`ачи вл`асти	Так`им `образом отмеч`ает газ`ета б`удет п`олностью завершён проц`есс перед`ачи 
руков`одству КНР	Так`им `образом отмеч`ает газ`ета б`удет п`олностью завершён проц`есс перед`ачи вл`асти н`овому руков`одству 
Т`ысячи люд`ей	Т`ысячи 
Т`ысячи люд`ей	Т`ысячи 
корреспонд`ент РИА	Как передаёт корреспонд`ент 
подн`ожия кол`онны	Как передаёт корреспонд`ент РИА Н`овости на больш`ом экр`ане пр`ямо у подн`ожия 
кол`онны Нельсона	Как передаёт корреспонд`ент РИА Н`овости на больш`ом экр`ане пр`ямо у подн`ожия кол`онны 
`Авторами саундтрека	`Авторами 
уч`астникам гр`уппы	В раб`оте над представл`ением уч`астникам 
Уч`астники ду`эта	Уч`астники 
с`ердце Л`ондона	Уч`астники ду`эта Нил Теннант и Крис Лоу сообщ`или что `очень р`ады б`ыли получ`ить возм`ожность напис`ать п`олный саундтрек к `этому класс`ическому ф`ильму и предст`авить ег`о на беспл`атном конц`ерте в с`ердце 
к`адры ф`ильма	В основн`ом к`адры 
ч`астности скр`ипки	В основн`ом к`адры ф`ильма сопровожд`ались инструмент`альной м`узыкой с`озданной с исп`ользованием электр`онных и стр`унных инструм`ентов в ч`астности 
ф`ильма Серг`ея	Музык`альное сопровожд`ение однозн`ачно обогат`ило визу`альный ряд и настро`ение почт`и полуторачасового ф`ильма 
Серг`ея Эйзенштейна	Музык`альное сопровожд`ение однозн`ачно обогат`ило визу`альный ряд и настро`ение почт`и полуторачасового ф`ильма Серг`ея 
ре`акции зр`ителей	`Это б`ыло зам`етно и по ре`акции 
мом`енты ф`ильма	Многонацион`альная толп`а вздохн`ув замир`ала в траг`ические мом`енты 
разв`итием д`ействия	Несмотр`я на дв`ажды приним`авшийся дождь л`юди не расход`ились а с интер`есом наблюд`али за разв`итием 
`образы ф`ильма	Гр`уппа Pet Shop Boys переосм`ыслила худ`ожественные `образы 
организ`атором пр`аздника	Гр`уппа Pet Shop Boys переосм`ыслила худ`ожественные `образы ф`ильма и исп`ользуя символ`изм Трафальгарской пл`ощади напис`ала `этот саундтрек кот`орый даёт ф`ильму н`овую жизнь счит`ают в лондонском Инстит`уте соврем`енного иск`усства кот`орый в`ыступил гл`авным организ`атором 
ст`атус нов`аторов	Изв`естные сво`ими ч`увственными и с`ильными п`еснями о городск`ой ж`изни и сво`ими эксперимент`альными раб`отами с разл`ичными режиссёрами и арт`истами он`и подтверд`или в `этой раб`оте свой ст`атус 
устро`ители представл`ения	Изв`естные сво`ими ч`увственными и с`ильными п`еснями о городск`ой ж`изни и сво`ими эксперимент`альными раб`отами с разл`ичными режиссёрами и арт`истами он`и подтверд`или в `этой раб`оте свой ст`атус нов`аторов сказ`али устро`ители 
Презид`ент Гр`еции	Презид`ент 
стади`оне стол`ицы	Презид`ент Гр`еции Константинос Стефанопулос откр`ыл сег`одня н`очью на центр`альном стади`оне 
стол`ицы Гр`еции	Презид`ент Гр`еции Константинос Стефанопулос откр`ыл сег`одня н`очью на центр`альном стади`оне стол`ицы 
ч`асти церем`онии	По заверш`ении основн`ой ч`асти 
церем`онии откр`ытия	По заверш`ении основн`ой ч`асти церем`онии 
откр`ытия Игр	По заверш`ении основн`ой ч`асти церем`онии откр`ытия 
прис`утствии премьер-мин`истра	По заверш`ении основн`ой ч`асти церем`онии откр`ытия Игр на стади`оне в прис`утствии 
премьер-мин`истра Гр`еции	По заверш`ении основн`ой ч`асти церем`онии откр`ытия Игр на стади`оне в прис`утствии премьер-мин`истра 
Гр`еции Константиноса	По заверш`ении основн`ой ч`асти церем`онии откр`ытия Игр на стади`оне в прис`утствии премьер-мин`истра Гр`еции 
гост`ей Игр	По заверш`ении основн`ой ч`асти церем`онии откр`ытия Игр на стади`оне в прис`утствии премьер-мин`истра Гр`еции Константиноса Караманлиса и презид`ента Междунар`одного Олимп`ийского комит`ета Жака Рогге был п`однят Паралимпийский флаг и зажжён Паралимпийский ог`онь Уч`астников и гост`ей 
презид`ент Оргкомит`ета	По заверш`ении основн`ой ч`асти церем`онии откр`ытия Игр на стади`оне в прис`утствии премьер-мин`истра Гр`еции Константиноса Караманлиса и презид`ента Междунар`одного Олимп`ийского комит`ета Жака Рогге был п`однят Паралимпийский флаг и зажжён Паралимпийский ог`онь Уч`астников и гост`ей Игр прив`етствовали презид`ент 
пар`аде сб`орных</w>-<w><ana lex="участник" gr="S,m,anim=pl,gen" joined="hyphen"></ana>уч`астников	Росс`ийский флаг на пар`аде 
сб`орных</w>-<w><ana lex="участник" gr="S,m,anim=pl,gen" joined="hyphen"></ana>уч`астников Игр	Росс`ийский флаг на пар`аде сб`орных</w>-<w><ana lex="участник" gr="S,m,anim=pl,gen" joined="hyphen"></ana>уч`астников 
чемпион`атах м`ира	Шесть лет пон`адобилось руков`одству миров`ого футб`ола чт`обы полож`ить кон`ец несанкционированному исп`ользованию сво`ей торг`овой м`арки на чемпион`атах 
интернетовских комп`аний	Шесть лет пон`адобилось руков`одству миров`ого футб`ола чт`обы полож`ить кон`ец несанкционированному исп`ользованию сво`ей торг`овой м`арки на чемпион`атах м`ира по футб`олу одн`ой из интернетовских 
поб`едой ФИФА	Шесть лет пон`адобилось руков`одству миров`ого футб`ола чт`обы полож`ить кон`ец несанкционированному исп`ользованию сво`ей торг`овой м`арки на чемпион`атах м`ира по футб`олу одн`ой из интернетовских комп`аний Суд обяз`ал америк`анскую комп`анию Сайкллоджик закр`ыть два с`айта КопаМундиал ком и КопаДоМундо ком ориент`ированных на испано и португалоязычную аудит`орию Лат`инской Ам`ерики Дир`ектор по маркетингу и ТВ Междунар`одной федер`ации Джером Валке назв`ал `это кр`упной поб`едой 
исп`ользования м`арки	Шесть лет пон`адобилось руков`одству миров`ого футб`ола чт`обы полож`ить кон`ец несанкционированному исп`ользованию сво`ей торг`овой м`арки на чемпион`атах м`ира по футб`олу одн`ой из интернетовских комп`аний Суд обяз`ал америк`анскую комп`анию Сайкллоджик закр`ыть два с`айта КопаМундиал ком и КопаДоМундо ком ориент`ированных на испано и португалоязычную аудит`орию Лат`инской Ам`ерики Дир`ектор по маркетингу и ТВ Междунар`одной федер`ации Джером Валке назв`ал `это кр`упной поб`едой ФИФА в борьб`е пр`отив несанкционированного исп`ользования 
мин`истр культ`уры	Об `этом сег`одня на пресс-конфер`енции в Иркутске заяв`ил мин`истр 
коммуник`аций РФ	Об `этом сег`одня на пресс-конфер`енции в Иркутске заяв`ил мин`истр культ`уры и м`ассовых коммуник`аций 
`Юрия Лотмана	Об `этом сег`одня на пресс-конфер`енции в Иркутске заяв`ил мин`истр культ`уры и м`ассовых коммуник`аций РФ Алекс`андр Сокол`ов Так по ег`о слов`ам ск`оро на кан`але Росс`ия б`удет возобновлён цикл Бес`ед о р`усской литерат`уре `Юрия 
тем`атика перед`ач	Расш`ирится и тем`атика 
рай`оне Чечн`и	В Грозненском рай`оне 
МВД Чечн`и	В Грозненском рай`оне Чечн`и сег`одня днём потерп`ел катастр`офу вертолёт Ми 24 сообщ`ил РБК ист`очник в МВД 
чл`енов экип`ажа	Од`ин из чл`енов 
рассл`едованию обсто`ятельств	С`оздана ком`иссия кот`орая приступ`ила к рассл`едованию 
обсто`ятельств катастр`офы	С`оздана ком`иссия кот`орая приступ`ила к рассл`едованию обсто`ятельств 
м`есте круш`ения	На м`есте 
круш`ения вертолёта	На м`есте круш`ения 
круш`ения вертолёта	Что же кас`ается нед`авнего круш`ения 
в`ыводу ком`иссии	Что же кас`ается нед`авнего круш`ения вертолёта Ми 8 в Ингушетии то по предвар`ительному в`ыводу 
рассл`едованию прич`ин	Что же кас`ается нед`авнего круш`ения вертолёта Ми 8 в Ингушетии то по предвар`ительному в`ыводу ком`иссии по рассл`едованию 
прич`ин ав`арии	Что же кас`ается нед`авнего круш`ения вертолёта Ми 8 в Ингушетии то по предвар`ительному в`ыводу ком`иссии по рассл`едованию прич`ин 
ош`ибка пил`ота	Что же кас`ается нед`авнего круш`ения вертолёта Ми 8 в Ингушетии то по предвар`ительному в`ыводу ком`иссии по рассл`едованию прич`ин ав`арии прич`иной `этому ст`ала ош`ибка 
войск МВД	Об `этом не пр`ошлой нед`еле сообщ`ил журнал`истам главк`ом Вн`утренних войск 
рассл`едование прич`ин	По ег`о слов`ам рассл`едование 
прич`ин катастр`офы	По ег`о слов`ам рассл`едование прич`ин 
катастр`офы вертолёта	По ег`о слов`ам рассл`едование прич`ин катастр`офы 
МВД РФ	Нап`омним связь с вертолётом Ми 8 принадлеж`ащим МВД 
аэроп`орта Гр`озного	Нап`омним связь с вертолётом Ми 8 принадлеж`ащим МВД РФ кот`орый в`ылетел из аэроп`орта 
ф`акту катастр`офы	По ф`акту 
катастр`офы вертолёта	По ф`акту катастр`офы 
УК Росс`ии	По ф`акту катастр`офы вертолёта Ми 8 возбужден`о угол`овное д`ело по ст 351 УК 
наруш`ение пр`авил	По ф`акту катастр`офы вертолёта Ми 8 возбужден`о угол`овное д`ело по ст 351 УК Росс`ии наруш`ение 
пр`авил полётов	По ф`акту катастр`офы вертолёта Ми 8 возбужден`о угол`овное д`ело по ст 351 УК Росс`ии наруш`ение пр`авил 
смерть челов`ека	По ф`акту катастр`офы вертолёта Ми 8 возбужден`о угол`овное д`ело по ст 351 УК Росс`ии наруш`ение пр`авил полётов `или подгот`овки к ним повлёкшее по неостор`ожности смерть 
мощь КНР	К 2040 г эконом`ическая мощь 
Экон`омика Кит`ая	Экон`омика 
мн`ению изд`ания	По мн`ению 
насел`ение Кит`ая	На сег`одняшний день насел`ение 
млрд челов`ек	На сег`одняшний день насел`ение Кит`ая превыш`ает 1 млрд 
рост ВВП	На сег`одняшний день насел`ение Кит`ая превыш`ает 1 млрд челов`ек рост 
кол`ичестве н`ефти	Раст`ущая кит`айская экон`омика нужд`ается всё в б`ольшем и б`ольшем кол`ичестве 
р`осту цен	Раст`ущая кит`айская экон`омика нужд`ается всё в б`ольшем и б`ольшем кол`ичестве н`ефти что прив`одит к р`осту 
мн`ение замминистра	Guardian ссыл`аясь на мн`ение 
замминистра обор`оны	Guardian ссыл`аясь на мн`ение замминистра 
обор`оны США	Guardian ссыл`аясь на мн`ение замминистра обор`оны 
Кит`ай нач`ала	Guardian ссыл`аясь на мн`ение замминистра обор`оны США П Вулфовица ср`авнивает Кит`ай 
Посл`едствием `этого	Посл`едствием 
Стремл`ение США	Стремл`ение 
подд`ержка незав`исимости	Стремл`ение США окруж`ить Кит`ай во`енными б`азами подд`ержка 
незав`исимости Тайваня	Стремл`ение США окруж`ить Кит`ай во`енными б`азами подд`ержка незав`исимости 
рост м`ощи	Несмотр`я на заявл`ения кит`айских власт`ей о том что рост 
м`ощи КНР	Несмотр`я на заявл`ения кит`айских власт`ей о том что рост м`ощи 
сист`ему безоп`асности	Несмотр`я на заявл`ения кит`айских власт`ей о том что рост м`ощи КНР не угрож`ает друг`им стр`анам Кит`ай б`удет стр`оить регион`альную сист`ему 
пут`и созд`ания	Несмотр`я на заявл`ения кит`айских власт`ей о том что рост м`ощи КНР не угрож`ает друг`им стр`анам Кит`ай б`удет стр`оить регион`альную сист`ему безоп`асности и скор`ее всег`о пойдёт по пут`и 
уч`астие КНР	Акт`ивное уч`астие 
жел`ании Пекина	Акт`ивное уч`астие КНР в урегул`ировании северокорейского кр`изиса говор`ит о жел`ании 
вли`яние США	Кит`ай сег`одня м`ожет оказ`ать и серьёзное эконом`ическое вли`яние 
вли`яние КНДР	Фин`ансовые анал`итики ср`авнивают вли`яние 
ст`епень разв`ития	Два соверш`енно р`азных соб`ытия в один`аковой ст`епени б`удут отраж`ать высоч`айшую ст`епень 
разв`ития `этого	Два соверш`енно р`азных соб`ытия в один`аковой ст`епени б`удут отраж`ать высоч`айшую ст`епень разв`ития 
`этого госуд`арства	Два соверш`енно р`азных соб`ытия в один`аковой ст`епени б`удут отраж`ать высоч`айшую ст`епень разв`ития `этого 
